11111111111111111111111111111111
10000C00C00000000000000000000001
10001110001111000111100011110001
100010100000C100000C100000C10001
10000010001111000111100000P10001
1000001000000100000C100000010001
10000111001111000111100000010C01
1000C0000000000000000000C000E001
11111111111111111111111111111111